$ANSIBLE_VAULT;1.1;AES256
66356565373433633637333135666331633931333334393130376338643131633237333466346637
3039653966643130336264326233653132343432323133630a396233343439323433633663666534
30316230306632643531666334346465313331336130613364396439336462363933373631393230
3239653431303434620a373866363839643462663736663862353136353730313630393066663936
35656162623162633564396164316435643563333332326235373465373139323430383932663332
62623861376538343266393239623566353663663336376135356433663230633937653835636565
62666532386135636537303834653635313230643037613131623735353234623731376536336237
34636137653932356333306337613966613331383939306138623730363863353431306464363165
62393537303334373339653734376332623565333762623064363933633030663234386135643331
3862373263323261666133656165313632343331353866393634
